1111111111111111111
1P000C000000C000001
1001111101111111001
1001C1C1C1C1C1C1011
1C000000000000000E1
100C1C1C1C1C1C1C001
1111111111111111111