1111111
10P0001
1111111
100E0C1
1111111